XXXX222XXXXXXXXXXXXXXXXXXXXXXXXXXXXXXXXXXXXXXXXXXXXXXXXXXXXXXXXXXXXXXXXXXXXXXXXXXXXXXXXXXXXXXXXXXXXXXXXXXX
X            XXGGGGGGGGGGGGGGGGGGGGGGGGGGGGGGGGGGGGGGGGGGGGGGGGGGGGGGGXX                                 X
X            XX    GGGGGGGG      GGGGGGGGG    GGGGGGGG   G GGGGG      XX                                 X
X            XX     GGGGG          GGGGG       GGGGG      GGGGG       XX                                 X
X            XX                      GG                               XX                                 X
X            XX                                                       XX                                 1
XXXXXXXXXXXXXXX                                                       XX                                 1
XXXXXXXXXXXXXXX                                                       XX                                 1
X                                                                     XX                                 X
X                                                                     XX                                 X
X                                                                      BB                                X
X                                                                      BB                                X
X                                                                     XXXXXXXXXXXXXXXXXXXXXXXXXXXXXXXXXXXX
X                                                                     XXXXXXXXXXXXXXXXXXXXXXXXXXXXXXXXXXXX
X                                                                                                 NNNNNNNX
X                                                                                          NNNNNNNNNNNNNNX
X                                                                                     NNNNNNNNNNNNNNNNNNNX
X                                                       NNNNNNNNNNNNNNNNNNNNNNNNNNNNNNNNNNNNNNNNNNNNNNNNNX
X                                                   NNNNNNNNNNNNNNNNNNNNNNNNNNNNNNNNNNNNNNNNNNNNNNNNNNNN X
X                                                 NNNNNNNNNNNNNNNNNNNNNNNNNNNNNNNNNNNNNNNNNNNNNNN        X
X                                               NNNNNNNNNNNNNNNNNNNNNNNNNNNNN                            X
X        X     X                NNNNNNNNNNNNNNNNNNNNNNNNNNNNNNNNNNNNNNNNNN                               X
XNNNNNNNNX     XNNNNNNNNNNNNNNNNNNNNNNNNNNNNNNNNNNNNNNNNNNNNNNNNNNNNNNNNN                                X
XNNNNNNNNX     XNNNNNNNNNNNNNNNNNNNNNNNNNNNNNNNNNNNNNNNNNNNNNNNNNNNNNNN                         GG G     X
XNNNNNNNNX     XNNNNNNNNNNNNNNNNNNNNNNNNNNNNNNNNNNNNNNNNNNNNNNNNNNN                            GGGGGGG   X
XNNNNNNNNX     XNNNNNNNNNNNNNNNNNNNNNNNNNNNNNNNNN                    GGGG        GGGG        GGGGGGGGGGXXX
XNNNNNNNNX     XNNNNNNNNNNNNNNNNNNNNNNN                            GGGGGG       GGGGGG        GGGGGGGGXXXX
X        X     X                                                  GGGGGGGG     GGGGGGGG        GGGGGGXX  1
X                                                                  GGGGGG        GGGG           GGGGXX   1
X                                                                    GGG           G               XX    1
X                                                                                                 XX     1
X                                                                                                        1
XXXXXXXXXXXXXXXXXXXXXXXXXXXXXXXXXXXXXXXXXXXXXXXXXXXXXXXXXXXXXXXXXXXXXXXXXXXXXXXXXXXXXXXXXXXXXXXXXXXXXXXXXX
