             XXVVVVVVVVVVVVVVVVVVVVVVVVVVVVVVVVVVVVVVVVVVVVVVVVVV     XX                                  
V            XXGGGGGGGGGGGGGGGGGGGGGGGGGGGGGGGGGGGGGGGGGGGGGGGGGG     XX                                  
V            XX    GGGGGGGG      GGGGGGGGG    GGGGGGGG   G GGGGG      XX                                  
V            XX     GGGGG          GGGGG       GGGGG      GGGGG       XX                                  
V            XX                      GG                               XX                                  
V            XX                                                       XX                                  
VXXXXXXXXXXXXXX                                                       XX                                  
VXXXXXXXXXXXXXX                                                       XX                                  
VVVV                                                                  XX                                  
VVVV                                                                  XX                                  
VVV                        ()                                                                             
VVV                                                                                                       
V                                                                     XXXXXXXXXXXXXXXXXXXXXXXXXXXXXXXXXXXX
VVVV                                                                  XXXXXXXXXXXXXXXXXXXXXXXXXXXXXXXXXXXX
VV                                                                                                NNNNNNNN
VVV                                                                                        NNNNNNNNNNNNNNN
VVVV                                                                                  NNNNNNNNNNNNNNNNNNNN
VV                                                      NNNNNNNNNNNNNNNNNNNNNNNNNNNNNNNNNNNNNNNNNNNNNNNNNN
VV                                                  NNNNNNNNNNNNNNNNNNNNNNNNNNNNNNNNNNNNNNNNNNNNNNNNNNNN  
VVV                                               NNNNNNNNNNNNNNNNNNNNNNNNNNNNNNNNNNNNNNNNNNNNNNN         
VV                                              NNNNNNNNNNNNNNNNNNNNNNNNNNNNN                             
VV      XX     XX               NNNNNNNNNNNNNNNNNNNNNNNNNNNNNNNNNNNNNNNNNN                                
NNNNNNNNXX     XXNNNNNNNNNNNNNNNNNNNNNNNNNNNNNNNNNNNNNNNNNNNNNNNNNNNNNNNN                                 
NNNNNNNNXX     XXNNNNNNNNNNNNNNNNNNNNNNNNNNNNNNNNNNNNNNNNNNNNNNNNNNNNNN                         GG G      
NNNNNNNNXX     XXNNNNNNNNNNNNNNNNNNNNNNNNNNNNNNNNNNNNNNNNNNNNNNNNNN                            GGGGGGG    
NNNNNNNNXX     XXNNNNNNNNNNNNNNNNNNNNNNNNNNNNNNNN                    GGGG        GGGG        GGGGGGGGGGXXX
NNNNNNNNXX     XXNNNNNNNNNNNNNNNNNNNNNN                            GGGGGG       GGGGGG        GGGGGGGGXXXX
VVV     XX     XX                                                 GGGGGGGG     GGGGGGGG        GGGGGGXX   
VV                                                                 GGGGGG        GGGG           GGGGXX    
VV                                                                   GGG           G               XX     
VV                                                                                                XX      
VVVVV                            VVVVVVVVVVVVVVVVVVVVVVVV                            VVVVVV               
VVVVVVVVVVVVVVVVVVVVVVVVVVVVVVVVVVVVVVVVVVVVVVVVVVVVVVVVVVVVVVVVVVVVVVVVVVVVVVVVVVVVVVVVVVVVVVVVVVVVVVVVVV
N:map3,E:map1
