V333333333333XXVVVVVVVVVVVVVVVVVVVVVVVVVVVVVVVVVVVVVVVVVVVVVVVVVV33333XX333333333333333333333333333333333 
V            XXGGGGGGGGGGGGGGGGGGGGGGGGGGGGGGGGGGGGGGGGGGGGGGGGGG     XX                                 1
V            XX    GGGGGGGG      GGGGGGGGG    GGGGGGGG   G GGGGG      XX                                 1
V            XX     GGGGG          GGGGG       GGGGG      GGGGG       XX                                 1
V            XX                      GG                               XX                                 1
V            XX                                                       XX                                 1
VXXXXXXXXXXXXXX                                                       XX                                 1
VXXXXXXXXXXXXXX                                                       XX                                 1
VVVV                                                                  XX                                 1
VVVV                                                                  XX                                 1
VVV                        ()                                                                            1
VVV                                                                                                      1
V                                                                     XXXXXXXXXXXXXXXXXXXXXXXXXXXXXXXXXXXX
VVVV                                                                  XXXXXXXXXXXXXXXXXXXXXXXXXXXXXXXXXXXX
VV                                                                                                NNNNNNNN
VVV                                                                                        NNNNNNNNNNNNNNN
VVVV                                                                                  NNNNNNNNNNNNNNNNNNNN
VV                                                      NNNNNNNNNNNNNNNNNNNNNNNNNNNNNNNNNNNNNNNNNNNNNNNNNN
VV                                                  NNNNNNNNNNNNNNNNNNNNNNNNNNNNNNNNNNNNNNNNNNNNNNNNNNNN 1
VVV                                               NNNNNNNNNNNNNNNNNNNNNNNNNNNNNNNNNNNNNNNNNNNNNNN        1
VV                                              NNNNNNNNNNNNNNNNNNNNNNNNNNNNN                            1
VV       X     X                NNNNNNNNNNNNNNNNNNNNNNNNNNNNNNNNNNNNNNNNNN                               1
NNNNNNNNNX     XNNNNNNNNNNNNNNNNNNNNNNNNNNNNNNNNNNNNNNNNNNNNNNNNNNNNNNNNN                                1
NNNNNNNNNX     XNNNNNNNNNNNNNNNNNNNNNNNNNNNNNNNNNNNNNNNNNNNNNNNNNNNNNNN                         GG G     1
NNNNNNNNNX     XNNNNNNNNNNNNNNNNNNNNNNNNNNNNNNNNNNNNNNNNNNNNNNNNNNN                            GGGGGGG   1
NNNNNNNNNX     XNNNNNNNNNNNNNNNNNNNNNNNNNNNNNNNNN                    GGGG        GGGG        GGGGGGGGGGXXX
NNNNNNNNNX     XNNNNNNNNNNNNNNNNNNNNNNN                            GGGGGG       GGGGGG        GGGGGGGGXXXX
VVV      X     X                                                  GGGGGGGG     GGGGGGGG        GGGGGGXX  1
VV                                                                 GGGGGG        GGGG           GGGGXX   1
VV                                                                   GGG           G               XX    1
VV                                                                                                XX     1
VVVVV                            VVVVVVVVVVVVVVVVVVVVVVVV                            VVVVVV              1
VVVVVVVVVVVVVVVVVVVVVVVVVVVVVVVVVVVVVVVVVVVVVVVVVVVVVVVVVVVVVVVVVVVVVVVVVVVVVVVVVVVVVVVVVVVVVVVVVVVVVVVVVV
N:map3,E:map1
