XXXXXXXXX333XXXXXXXXXXXXXXXXXXXXXXXXXXXXXXXXXXXXXXXXXXXXXXXXXXXXXXXXXXXXXXXXXXXXXXXXXXXXXXXXXXXXXXXXX333XX
X            XX                                                                    XX         XX         X
X            XX                                                                    XX          XX        X
X   FF       XX       FFF                                                          XX      F F  XX       X
X     F      XX                                                                    XX            XX      X
0      F     XX                                       FFF             XX           XX      F F F  XX     X
0       F    XX                                                       XXXXXXXXXXXXXXXXX            XX    X
0        F   XX                                                       XX       FF     X    F F F F  XX   X
XXXXXXXXXXXXXXX                                                       XX FF           X              XX  X
XXXXXXXXXXXXXXX                   NNNNNNNNN                           XX              X    F F F F F  XX X
X                                NNNNNNNNNNNNN GGGGG                  XX   FF     FF         F F F     XXX
X                             NNNNNNNNNNNNNNNNNNNGGG     FF           XXXXXXXXXXXXXXXXX                 XX
X            GGGGG           NNNNNNNNNNNNNNNNNNNNNG                   XX  FFFF        X      FFFFF      XX
X             GGGGGG       NNNNNNNNNNNNNNNNNNNNNNNNNN                 XX          FF  X       FFF        X
XNNNN        GGGGGGGGG    NNNNNNNNNNNNNNNNNNNNNNNNNNNNNNN  FF         XXXXXXXXXXXXXXXXXXXXXXXXXXXXXXXXXXXX
XNNNNNNNN  GGGGGGGGGNNNNNNNNNNNNNNNNNNNNNNNNNNNNNNNNNNNNNNN           XXXXXXXXXXXXXXXXXXXXXXXXXXXXXXXXXXXX
XNNNNNNNNNNNNNNNNNNNNNNNNNNNNNNNNNNNNNNNNNNNNNNNNNNNNNNNNNNNNN                                           7
XNNNNNNNNNNNNNNNNNNNNNNNNNNNNNNNNNNNNNNNNNNNNNNNNNNNNNNNNNNNNNNGGGG                    GG                7
X      NNNNNNNNNNNNNNNNNNNNNNNNNNNNNNNNNNNNNNNNNNNNNNNNNNNNNNNNNNGGGGG               GGG                 7
X     GGGGNNNNNNNNNNNNNNNNNNNNNNNNNNNNNNNNNNNNNNNNNNNNNNNNNNNNNNNNGGG               GGG                  7
X       GGGG  NNNNNNNNNNNNNNNNNNNNNNNNNNNNNNNNNNNNNNNNNNNNNNNNNNNNNNNNNNN            GGG               GGX
X         GGG         NNNNNNNNNNNNNNNNNNNNNNNNNNNNNNNNNNNNNNNNNNNNNNNNNNNNNNN         GG                GX
X       GGGGG              NNNNNNNNNNNNNNNNNNNNNNNNNNNNNNNNNNNNNNNNNNNNNNNNNN                          GGX
X          GGGGG                NNNNNNNNNNNNNNNNNNNNNNNNNNNNNNNNNNNNNNNNNNNNNN                        GGGX
X                                           NNNNNNNNNNNNNNNNNNNNNNNNNNNNNNNNNNN                   GGG  GGX
XXXXXXXXXXXXXXXXXXXXXXXXXXXXXXXXXXXXXXXXXXXXXXXXXXXXXXXXXXXXNNNNNNNNNNNNNNNNNNNN              GGGGGGGGGGGX
XXXXXXXXXXXXXXXXXXXXXXXXXXXXXXXXXXXXXXXXXXXXXXXXXXXXXXXXXXXX         GNNNNNNNNNNNGGGG     GGGGGGGGGGGGGGGX
0    FF                                     FF     FFF    XX       GGGGGNNNNNNNNNNGGGG  GGGGGGGGGGGGGG GGX
0         FF                                              XX      GGGGGGGNNNNNNNNNGGGGG        GGGGGG   GX
0  FF                                         FFF         XX       GGGGGGNNNNNNNNNGGG           GGGG    GX
0       FF         FF                                     XX         GGGXXXXXXXXXXXXX                   GX
0                FF                                                                                      X
XXXXXXXXXXXXXXXXXXXXXXXXXXXXXXXXXXXXXXXXXXXXXXXXXXXXXXXXXXXXXXXXXXXXXXXXXXXXXXXXXXXXXXXXXXXXXXXXXXXXXXXXXX
