             XX                    VVVVVVVVVVVVVVV               VVVVVVVV          XX        XX           
             XX                     GGGG GG GGGGG                 GGGG GG          XX         XX          
             XX                      G G  G  GGG                  G     G          XX          XX         
    FF       XX       FFF                                            G             XX      F F  XX        
      F      XX                                                      GGGG          XX            XX       
       F     XX                                       FFF           GGXXGG         XX      F F F  XX      
        F    XX                                                     GGXXXXXXXXXXXXXXXXX            XX     
         F   XX                                                      GXX       FF     X    F F F F  XX    
     XXXXXXXXXX                                                       XX FF           X              XX   
     XXXXXXXXXX                   NNNNNNNNN                           XX              X    F F F F F  XX  
     XX                          NNNNNNNNNNNNN GGGGG                  XX   FF     FF         F F F     XXX
     XX                       NNNNNNNNNNNNNNNNNNNGGG     FF           XXXXXXXXXXXXXXXXX                 XX
XXXXXXX      GGGGG           NNNNNNNNNNNNNNNNNNNNNG                   XX  FFFF        X      FFFFF        
XXXXXXX       GGGGGG       NNNNNNNNNNNNNNNNNNNNNNNNNN                 XX          FF  X       FFF         
NNNNN        GGGGGGGGG    NNNNNNNNNNNNNNNNNNNNNNNNNNNNNNN  FF         XXXXXXXXXXXXXXXXXXXXXXXXXXXXXXXXXXXX
NNNNNNNNN  GGGGGGGGGNNNNNNNNNNNNNNNNNNNNNNNNNNNNNNNNNNNNNNN           XXXXXXXXXXXXXXXXXXXXXXXXXXXXXXXXXXXX
NNNNNNNNNNNNNNNNNNNNNNNNNNNNNNNNNNNNNNNNNNNNNNNNNNNNNNNNNNNNNN                                            
NNNNNNNNNNNNNNNNNNNNNNNNNNNNNNNNNNNNNNNNNNNNNNNNNNNNNNNNNNNNNNNGGGG                    GG                 
       NNNNNNNNNNNNNNNNNNNNNNNNNNNNNNNNNNNNNNNNNNNNNNNNNNNNNNNNNNGGGGG               GGG                  
      GGGGNNNNNNNNNNNNNNNNNNNNNNNNNNNNNNNNNNNNNNNNNNNNNNNNNNNNNNNNGGG               GGG                   
        GGGG  NNNNNNNNNNNNNNNNNNNNNNNNNNNNNNNNNNNNNNNNNNNNNNNNNNNNNNNNNNN            GGG               GGX
          GGG         NNNNNNNNNNNNNNNNNNNNNNNNNNNNNNNNNNNNNNNNNNNNNNNNNNNNNNN         GG                GX
        GGGGG              NNNNNNNNNNNNNNNNNNNNNNNNNNNNNNNNNNNNNNNNNNNNNNNNNN                          GGX
           GGGGG                NNNNNNNNNNNNNNNNNNNNNNNNNNNNNNNNNNNNNNNNNNNNNN                        GGGX
                                            NNNNNNNNNNNNNNNNNNNNNNNNNNNNNNNNNNN                   GGG  GGX
XXXXXXXXXXXXXXXXXXXXXXXXXXXXXXXXXXXXXXXXXXXXXXXXXXXXXXXXXXXXNNNNNNNNNNNNNNNNNNNN              GGGGGGGGGGGX
XXXXXXXXXXXXXXXXXXXXXXXXXXXXXXXXXXXXXXXXXXXXXXXXXXXXXXXXXXXX         GNNNNNNNNNNNGGGG     GGGGGGGGGGGGGGGX
     FF                                     FF     FFF    XX       GGGGGNNNNNNNNNNGGGG  GGGGGGGGGGGGGG GGX
          FF                                              XX      GGGGGGGNNNNNNNNNGGGGG        GGGGGG   GX
   FF                                         FFF         XX       GGGGGGNNNNNNNNNGGG           GGGG    GX
        FF         FF                                     XX         GGGXXXXXXXXXXXXX                   GX
                 FF                                                                                       
VVVVVVVVVVVVVVVVVVVVVVVVVVVVVVVVVVVVVVVVVVVVVVVVVVVVVVVVVVVVVVVVVVVVVVVVVVVVVVVVVVVVVVVVVVVVVVVVVVVVVVVVVV
N:map4,E:map2,W:map0
