             XX                    VVVVVVVVVVVVVVV               VVVVVVVV          XX        DD           
             XX                     GGGG GG GGGGG                 GGGG GG          XX         DD          
             XX                      G G  G  GGG                  G     G          XX          DD         
             XX                                                      G             XX           DD        
             XX                                                      GGGG          XX            DD       
             XX                                                     GGXXGG         XX             DD      
             XX                                                     GGXXDDDDDDDDDDDDDDD            DD     
             XX                                                      GXX              D             DD    
     XXXXXXXXXX                                                       XX              D              DD   
     XXXXXXXXXX                   NNNNNNNNN                           XX              D               DD  
     XX                          NNNNNNNNNNNNN GGGGG                  XX                               DDD
     XX                       NNNNNNNNNNNNNNNNNNNGGG                  XXDDDDDDDDDDDDDDD                 DD
XXXXXXX      GGGGG           NNNNNNNNNNNNNNNNNNNNNG                   XX              D                   
XXXXXXX       GGGGGG       NNNNNNNNNNNNNNNNNNNNNNNNNN                 XX              D                   
NNNNN        GGGGGGGGG    NNNNNNNNNNNNNNNNNNNNNNNNNNNNNNN             XXXXXXXXXXXXXXXXXXXXXXXXXXXXXXXXXXXX
NNNNNNNNN  GGGGGGGGGNNNNNNNNNNNNNNNNNNNNNNNNNNNNNNNNNNNNNNN           XXXXXXXXXXXXXXXXXXXXXXXXXXXXXXXXXXXX
NNNNNNNNNNNNNNNNNNNNNNNNNNNNNNNNNNNNNNNNNNNNNNNNNNNNNNNNNNNNNN                                            
NNNNNNNNNNNNNNNNNNNNNNNNNNNNNNNNNNNNNNNNNNNNNNNNNNNNNNNNNNNNNNNGGGG                    GG                 
       NNNNNNNNNNNNNNNNNNNNNNNNNNNNNNNNNNNNNNNNNNNNNNNNNNNNNNNNNNGGGGG               GGG                  
      GGGGNNNNNNNNNNNNNNNNNNNNNNNNNNNNNNNNNNNNNNNNNNNNNNNNNNNNNNNNGGG               GGG                   
        GGGG  NNNNNNNNNNNNNNNNNNNNNNNNNNNNNNNNNNNNNNNNNNNNNNNNNNNNNNNNNNN            GGG               GGV
          GGG         NNNNNNNNNNNNNNNNNNNNNNNNNNNNNNNNNNNNNNNNNNNNNNNNNNNNNNN         GG                GV
        GGGGG              NNNNNNNNNNNNNNNNNNNNNNNNNNNNNNNNNNNNNNNNNNNNNNNNNN                          GGV
           GGGGG                NNNNNNNNNNNNNNNNNNNNNNNNNNNNNNNNNNNNNNNNNNNNNN                        GGGV
                                            NNNNNNNNNNNNNNNNNNNNNNNNNNNNNNNNNNN                   GGG  GGV
XXXXXXXXXXXXXXXXXXXXXXXXXXXXXXXXXXXXXXXXXXXXXXXXXXXXXXXXXXXXNNNNNNNNNNNNNNNNNNNN              GGGGGGGGGGGV
XXXXXXXXXXXXXXXXXXXXXXXXXXXXXXXXXXXXXXXXXXXXXXXXXXXXXXXXXXXX         GNNNNNNNNNNNGGGG     GGGGGGGGGGGGGGGV
                                                          XX       GGGGGNNNNNNNNNNGGGG  GGGGGGGGGGGGGG GGV
                                                 ~~~~~~~~~XX~~~~~~GGGGGGGNNNNNNNNNGGGGG        GGGGGG   GV
                                                 ~~~~~~~~~XX~~~~~~ GGGGGGNNNNNNNNNGGG           GGGG    GV
                                                 ~~~~~~~~~XX~~~~~~   GGGXXXXXXXXXXXXX                   GV
                                                 ~~~~~~~~~~~~~~~~~                                        
VVVVVVVVVVVVVVVVVVVVVVVVVVVVVVVVVVVVVVVVVVVVVVVVVVVVVVVVVVVVVVVVVVVVVVVVVVVVVVVVVVVVVVVVVVVVVVVVVVVVVVVVVV
N:map4,E:map2,W:map0
