             XX                    VVVVVVVVVVVVVVV               VVVVVVVV          XX        DD           
             XX                     GGGG GG GGGGG                 GGGG GG          XX         DD          
             XX                      G G  G  GGG                  G     G          XX          DD         
    FF       XX       FFF                                            G             XX      F F  DD        
      F      XX                                                      GGGG          XX            DD       
       F     XX                                       FFF           GGXXGG         XX      F F F  DD      
        F    XX                                                     GGXXDDDDDDDDDDDDDDD            DD     
         F   XX                                                      GXX       FF     D    F F F F  DD    
     XXXXXXXXXX                                                       XX FF           D              DD   
     XXXXXXXXXX                   NNNNNNNNN                           XX              D    F F F F F  DD  
     XX                          NNNNNNNNNNNNN GGGGG                  XX   FF     FF         F F F     DDD
     XX                       NNNNNNNNNNNNNNNNNNNGGG     FF           XXDDDDDDDDDDDDDDD                 DD
XXXXXXX      GGGGG           NNNNNNNNNNNNNNNNNNNNNG                   XX  FFFF        D      FFFFF        
XXXXXXX       GGGGGG       NNNNNNNNNNNNNNNNNNNNNNNNNN                 XX          FF  D       FFF         
NNNNN        GGGGGGGGG    NNNNNNNNNNNNNNNNNNNNNNNNNNNNNNN  FF         XXXXXXXXXXXXXXXXXXXXXXXXXXXXXXXXXXXX
NNNNNNNNN  GGGGGGGGGNNNNNNNNNNNNNNNNNNNNNNNNNNNNNNNNNNNNNNN           XXXXXXXXXXXXXXXXXXXXXXXXXXXXXXXXXXXX
NNNNNNNNNNNNNNNNNNNNNNNNNNNNNNNNNNNNNNNNNNNNNNNNNNNNNNNNNNNNNN                                            
NNNNNNNNNNNNNNNNNNNNNNNNNNNNNNNNNNNNNNNNNNNNNNNNNNNNNNNNNNNNNNNGGGG                    GG                 
       NNNNNNNNNNNNNNNNNNNNNNNNNNNNNNNNNNNNNNNNNNNNNNNNNNNNNNNNNNGGGGG               GGG                  
      GGGGNNNNNNNNNNNNNNNNNNNNNNNNNNNNNNNNNNNNNNNNNNNNNNNNNNNNNNNNGGG               GGG                   
        GGGG  NNNNNNNNNNNNNNNNNNNNNNNNNNNNNNNNNNNNNNNNNNNNNNNNNNNNNNNNNNN            GGG               GGV
          GGG         NNNNNNNNNNNNNNNNNNNNNNNNNNNNNNNNNNNNNNNNNNNNNNNNNNNNNNN         GG                GV
        GGGGG              NNNNNNNNNNNNNNNNNNNNNNNNNNNNNNNNNNNNNNNNNNNNNNNNNN                          GGV
           GGGGG                NNNNNNNNNNNNNNNNNNNNNNNNNNNNNNNNNNNNNNNNNNNNNN                        GGGV
                                            NNNNNNNNNNNNNNNNNNNNNNNNNNNNNNNNNNN                   GGG  GGV
XXXXXXXXXXXXXXXXXXXXXXXXXXXXXXXXXXXXXXXXXXXXXXXXXXXXXXXXXXXXNNNNNNNNNNNNNNNNNNNN              GGGGGGGGGGGV
XXXXXXXXXXXXXXXXXXXXXXXXXXXXXXXXXXXXXXXXXXXXXXXXXXXXXXXXXXXX         GNNNNNNNNNNNGGGG     GGGGGGGGGGGGGGGV
     FF                                     FF     FFF    XX       GGGGGNNNNNNNNNNGGGG  GGGGGGGGGGGGGG GGV
          FF                                              XX      GGGGGGGNNNNNNNNNGGGGG        GGGGGG   GV
   FF                                         FFF         XX       GGGGGGNNNNNNNNNGGG           GGGG    GV
        FF         FF                                     XX         GGGXXXXXXXXXXXXX                   GV
                 FF                                                                                       
VVVVVVVVVVVVVVVVVVVVVVVVVVVVVVVVVVVVVVVVVVVVVVVVVVVVVVVVVVVVVVVVVVVVVVVVVVVVVVVVVVVVVVVVVVVVVVVVVVVVVVVVVV
N:map4,E:map2,W:map0
