                  XX                    VVVVVVVVVV                                  NNNNNNNNNNNNNNNNNNNNNN
                   XX                    GG GGGGG                                   NNNNNNNNNNNNNNNNNNNNNN
                    XX                    G  GGG                                     NNNNNNNNNNNNNNNNNNNNN
                     XX                                                               NNNNNNNNNNNNNNNNNNNN
                      XX                                             GGGG               NNNNNNNNNNNNNNNNNN
                       XX                                           GGGGGG               NNNNNNNNNNNNNNNNN
                        XXXXXXXXXXXXXXXX                            GGGGG               NNNNNNNNNNNNNNNNNN
                         XXXXXXXXXXXXXXX                             GGGG               NNNNNNNNNNNNNNNNNN
                                      XX                               G                   NNNNNNNNNNNNNNN
                                      XX                                                     NNNNNNNNNNNNN
D                                     XX                                                        NNNNNNNNNN
D                                     XX                                                          NNNN  NN
                                      XX                                                                 V
                                      XX                                                                 V
XXXXXXXXXXXXXXXXXXXXXXXXXXXXXXXXXXXXXXXX                                                                 V
XXXXXXXXXXXXXXXXXXXXXXXXXXXXXXXXXXXXXXXX                         GG                                      V
                                                                 GGGG                                    V
                                                              GGGGG                                      V
                                                                 GGGGG                                   V
      GGGG                                                        GGG                 DDDDDDDDDDDDDDDDDDDX
        GGGG                                                                        DD D                 X
          GGG                                                                     DD    D                X
        GGGGG                                                                   DD       D               X
           GGGGG                                                               DD         D              X
                                                     G                        DD           XXXXXXXXXXXXXXX
                                                  G  GGG                     D DDD       XXXXGGGGGGGGGGGGV
                                             G    GG GGGG            G       D    DDDD XXXGGGGGGGGGGGGGGGV
                                           GGGG   GGGG             GGGGG     D        DXGGGGGGGGGGGGGGGGGV
                                            GGG  GGG              GGGGGGG    D         XGGGGGGGGGGGGGGGGGV
                                             GGGGGG                GGGGGG    D         XGGGGGGGGGGGGGGGGGV
                                               GGG                   GGG     D         XGGGGGGGGGGGGGGGGGV
                                                G                            D         XGGGGGGGGGGGGGGGGGV
VVVVVVVVVVVVVVVVVVVVVVVVVVVVVVVVVVVVVVVVVVVVVVVVVVVVVVVVVVVVVVVVVVVVVVVVVVVVVXXXXXXXXXXXVVVVVVVVVVVVVVVVVV
N:map5,W:map1
