                  XX                    VVVVVVVVVV                                  NNNNNNNNNNNNNNNNNNNNNN
                   XX                    GG GGGGG                                   NNNNNNNNNNNNNNNNNNNNNN
                    XX                    G  GGG                                     NNNNNNNNNNNNNNNNNNNNN
                     XX                                                               NNNNNNNNNNNNNNNNNNNN
                      XX                                             GGGG               NNNNNNNNNNNNNNNNNN
                       XX                             FFF           GGGGGG               NNNNNNNNNNNNNNNNN
                        XXXXXXXXXXXXXXXX                            GGGGG               NNNNNNNNNNNNNNNNNN
                         XXXXXXXXXXXXXXX                             GGGG      FF       NNNNNNNNNNNNNNNNNN
                                      XX                               G FF                NNNNNNNNNNNNNNN
                                      XX                                                     NNNNNNNNNNNNN
X                                     XX                                   FF     FF            NNNNNNNNNN
X                                     XX                 FF                                       NNNN  NN
                                      XX                                  FFFF               FFFFF       V
                                      XX                                          FF          FFF        V
XXXXXXXXXXXXXXXXXXXXXXXXXXXXXXXXXXXXXXXX                   FF                                            V
XXXXXXXXXXXXXXXXXXXXXXXXXXXXXXXXXXXXXXXX                         GG                                      V
                                                                 GGGG                                    V
                                                              GGGGG                                      V
                                                                 GGGGG                                   V
      GGGG                                                        GGG                 XXXXXXXXXXXXXXXXXXXX
        GGGG                                                                        XX X                 X
          GGG                                                                     XX    X                X
        GGGGG                                                                   XX       X               X
           GGGGG                                                               XX         X              X
                                                     G                        XX           XXXXXXXXXXXXXXX
                                                  G  GGG                     X XXX       XXXXGGGGGGGGGGGGV
                                             G    GG GGGG            G       X    XXXX XXXGGGGGGGGGGGGGGGV
     FF                                    GGGG   GGGG             GGGGG     X        XXGGGGGGGGGGGGGGGGGV
          FF                                GGG  GGG              GGGGGGG    X         XGGGGGGGGGGGGGGGGGV
   FF                                        GGGGGG                GGGGGG    X         XGGGGGGGGGGGGGGGGGV
        FF         FF                          GGG                   GGG     X         XGGGGGGGGGGGGGGGGGV
                 FF                             G                            X         XGGGGGGGGGGGGGGGGGV
VVVVVVVVVVVVVVVVVVVVVVVVVVVVVVVVVVVVVVVVVVVVVVVVVVVVVVVVVVVVVVVVVVVVVVVVVVVVVXXXXXXXXXXXVVVVVVVVVVVVVVVVVV
N:map5,W:map1
