                  XX                    VVVVVVVVVV                                  NNNNNNNNNNNNNNNNNNNNNN
                   XX                    GG GGGGG                                   NNNNNNNNNNNNNNNNNNNNNN
                    XX                    G  GGG                                     NNNNNNNNNNNNNNNNNNNNN
                     XX                                                               NNNNNNNNNNNNNNNNNNNN
                      XX                                             GGGG               NNNNNNNNNNNNNNNNNN
                       XX                             FFF           GGGGGG               NNNNNNNNNNNNNNNNN
                        XXXXXXXXXXXXXXXX                            GGGGG               NNNNNNNNNNNNNNNNNN
                         XXXXXXXXXXXXXXX                             GGGG      FF       NNNNNNNNNNNNNNNNNN
                                      XX                               G FF                NNNNNNNNNNNNNNN
                                      XX                                                     NNNNNNNNNNNNN
D                                     XX                                   FF     FF            NNNNNNNNNN
D                                     XX                 FF                                       NNNN  NN
                                      XX                                  FFFF               FFFFF       V
                                      XX                                          FF          FFF        V
XXXXXXXXXXXXXXXXXXXXXXXXXXXXXXXXXXXXXXXX                   FF                                            V
XXXXXXXXXXXXXXXXXXXXXXXXXXXXXXXXXXXXXXXX                         GG                                      V
                                                                 GGGG                                    V
                                                              GGGGG                                      V
                                                                 GGGGG                                   V
      GGGG                                                        GGG                 DDDDDDDDDDDDDDDDDDDX
        GGGG                                                                        DD D                 X
          GGG                                                                     DD    D                X
        GGGGG                                                                   DD       D               X
           GGGGG                                                               DD         D              X
                                                     G                        DD           XXXXXXXXXXXXXXX
                                                  G  GGG                     D DDD       XXXXGGGGGGGGGGGGV
                                             G    GG GGGG            G       D    DDDD XXXGGGGGGGGGGGGGGGV
     FF                                    GGGG   GGGG             GGGGG     D        DXGGGGGGGGGGGGGGGGGV
          FF                                GGG  GGG              GGGGGGG    D         XGGGGGGGGGGGGGGGGGV
   FF                                        GGGGGG                GGGGGG    D         XGGGGGGGGGGGGGGGGGV
        FF         FF                          GGG                   GGG     D         XGGGGGGGGGGGGGGGGGV
                 FF                             G                            D         XGGGGGGGGGGGGGGGGGV
VVVVVVVVVVVVVVVVVVVVVVVVVVVVVVVVVVVVVVVVVVVVVVVVVVVVVVVVVVVVVVVVVVVVVVVVVVVVVXXXXXXXXXXXVVVVVVVVVVVVVVVVVV
N:map5,W:map1
