V222222222222XX222222222222222222222222222222222222222222222222222222222222222222222222222222222222222222 
V            XX                                                                                          5
V            XX                                                                     XXXXXXXXXXXXXXXXXXXXXX
V        F   XX                                                                     XXXXXXXXXXXXXXXXXXXXXX
V   F  F F   XX                                        G  G                         XX                   5
V            XX                             G G        GG G                         XX                   5
V            XX                             GGGG      GGGG     G                    XX      F     F      5
VDDDDDDDDDDDDXX                            GGGGG       GG     GGG                   XX                   5
V            XX                             GGGGG           GGGGGG                  XX                F  5
V       F    XX                             GG    XXXXX    GGGGGGGG                 XXXXXXXXXXXXXXXXXXXXXX
V            XX                                XXXNNNNNXXX   GGGGG                  XXXXXXXXXXXXXXXXXXXXXX
V            XX                      G G     XXXNNNNNNNNNXXX   GG                                        5
V            XX                      GGGG   XXNNNNNNNNNNNNNXX   G                                        5
V  F         XX                   GGGGGGG   XNNNNNNXXXNNNNNNX                                            5
V            XX                     GGGGG   XNNNNNNXXXNNNNNNX                                         XXXX
V           AA                     GGGGGG   XXNNNNNNNNNNNNNXX G                                       XXXX
V           AA                       GG      XXXNNNNNNNNNXXX GG                                  G G  XX 5
V     XXXXXXXXX                                XXXNNNNNXXX  GGGG                                 GG   XX 5
V     F      XX                             G     XXXXX    GGGGG                              GG G    XX 5
V            XX                            GGG              GG                                GGGG    XX 5
V            XX                           GGGGG     G G G   G                                   GG    XX 5
V            XXG                          GGGGG    GGGGGGGG                                    GGG    XX 5
V            XXGGG                         GGG     GGGGGGGG                                  GGGG     XX 5
V            XXGG                           G       GGGGG             XXXXXXXXXXXXXXXXXXXXXXXXXXXXXXXXXX 5
V      F     XXG                                      G               XXXXXXXXXXXXXXXXXXXXXXXXXXXXXXXXXX 5
V            XXGGG                                                    XX           F                     5
VXXXXXXXXX   XXGGGGG                                                  XX     F                 F         5
V            XXGGGG                                                   XX            F                    5
V            XXGGG            G                                       XX                              FF 5
V            XXGG           GGGGG     GG     GG        GGGG           XX              F                  5
V            XXGGGG  GGGGGGGGGGGGGGGGGGGGG GGGGGG    GGGGGGGGGG       XX                    F            5
V            XXGGGGGGGGGGGGGGGGGGGGGGGGGGGGGGGGGGGGGGGGGGGGGGGGGG     XX                                 5
VVVVVVVVVVVVVVVVVVVVVVVVVVVVVVVVVVVVVVVVVVVVVVVVVVVVVVVVVVVVVVVVV00000XXVVVVVVVVVVVVVVVVVVVVVVVVVVVVVVVVVV
