 77777777777777777777777777777777777777777777777777777777777777777777777777777777777777777777777777777777 
3              D                                                                    D                    5
XXXXXXXXXXXXXXXXXXXXXXXXXXXXXXXXXXXXXXXXXXXXXXXXXXXXXXXXXXXXXXXXXXXXXXXXXXXXXXXXXXXXXXXXXXXXXXXXXXXXXXXXXX
XXXXXXXXXXXXXXXXXXXXXXXXXXXXXXXXXXXXXXXXXXXXXXXXXXXXXXXXXXXXXXXXXXXXXXXXXXXXXXXXXXXXXXXXXXXXXXXXXXXXXXXXXX
3                                              D               F             F      XX                   5
3          F                         F         D   F                                XX                   5
3                   F F  F                     D                                    XX                   5
3    F          F F                            D                                    XX                   5
3                                F             D                       F F F        XX     FF            5
XXXXXXXXXXXXXXXXXXXXXXXXXXXXXX  XXXXXXXXXXXXXXXX       F        F     F             XX                   5
XXXXXXXXXXXXXXXXXXXXXXXXXXXXXX  XXXXXXXXXXXXXXXX                                    XX                   5
3             D                          GGGGGXX                                    XX      F            5
3             D                            GGGXX  FF                      F         XX      FF           5
3             D                           GGGGXX                                    XX                   5
XXXXXXXXXXXXXXX                             GGXX                                    XX                   5
XXXXXXXXXXXXXXX                               XXXXXXXXXXXXXXXXXXXXXXXXXXXXXXXXXXXXXXXXDDDDDDDDDDDDDDDDDDDD
3      F     XX                               XXXXXXXXXXXXXXXXXXXXXXXXXXXXXXXXXXXXXXXX                   5
3            XX                                                          GGGGGGGGG  XX     F    F        5
3            XX                                                           GGGGGG    XX             F     5
3            XX                                                             GGGGG   XX                   5
3      F     XX                                                            GGGG     XX                   5
3  F F       XX                                                          GG   GG    XX        F          5
3            XX                                     G                               XX       F           5
3            XX                                    GGG                              XX                   5
3            XX                                   GGGGG                             XXX        F         5
3            XX                                     GGGG                            XXXX                 5
3            XX                                     GGG                             XX XX                5
3        FF                                         GGGGG                               XX          F    5
3     FF                      G                        GG                                XX              5
3            XX             GGGGG     GG     GG        GGGG  GG  GG       G         XX    XX             5
3            XX              GGGG     GGGG GGGGGG    GGGGGGGG  GG GGG    GGG        XX     XX            5
3            XX                      GGGGGGGGGGGGG                GGGGGGGG          XX      XX           5
V111111111111XX111111111111111111111VVVVVVVVVVVVVVV111111111111111VVVVVVVV1111111111XX1111111XX1111111111X
