                                                                                                          
                                                                                                          
XXXXXXXXXXXXXXXXXXXXXXXXXXXXXXXXXXXXXXXXXXXXXXXXXXXXXXXXXXXXXXXXXXXXXXXXXXXXXXXXXXXXXXXXXXXXXXXXXXXXXXXXXX
XXXXXXXXXXXXXXXXXXXXXXXXXXXXXXXXXXXXXXXXXXXXXXXXXXXXXXXXXXXXXXXXXXXXXXXXXXXXXXXXXXXXXXXXXXXXXXXXXXXXXXXXXX
                                               D               F             F       D                    
           F                         F         D   F                                 D                    
                    F F  F                     D                                     D                    
     F          F F                            D                                     D                    
                                 F             D                       F F F         D     FF             
XXXXXXXXXXXXXXXXXXXXXXXXXXXXXX  XXXXXXXXXXXXXXXX       F        F     F              D                    
XXXXXXXXXXXXXXXXXXXXXXXXXXXXXX  XXXXXXXXXXXXXXXX                                     D                    
              D                          GGGGGXX                                     D      F             
              D                            GGGXX  FF                      F          D      FF            
              D                           GGGGXX                                     D                    
XXXXXXXXXXXXXXX                             GGXX                                     D                    
XXXXXXXXXXXXXXX                               XXXXXXXXXXXXXXXXXXXXXXXXXXXXXXXXXXXXXXXXDDDDDDDDDDDDDDDDDDDD
       F     XX                               XXXXXXXXXXXXXXXXXXXXXXXXXXXXXXXXXXXXXXXX                    
             XX                                                          GGGGGGGGG  XX     F    F         
             XX                                                           GGGGGG    XX             F      
             XX                                                             GGGGG   XX                    
       F     XX                                                            GGGG     XX                    
   F F       XX                                                          GG   GG    XX        F           
             XX                                     G                               XX       F            
             XX                                    GGG                              XX                    
             XX                                   GGGGG                             XXD        F          
             XX                                     GGGG                            XXDD                  
             XX                                     GGG                             XX DD                 
         FF                                         GGGGG                               DD          F     
      FF                      G                        GG                                DD               
             XX             GGGGG     GG     GG        GGGG  GG  GG       G         XX    DD              
             XX              GGGG     GGGG GGGGGG    GGGGGGGG  GG GGG    GGG        XX     DD             
             XX                      GGGGGGGGGGGGG                GGGGGGGG          XX      DD            
             XX                     VVVVVVVVVVVVVVV               VVVVVVVV          XX       DD           
N:map7,E:map5,W:map3,S:map1
