                                                                                                          
                                                                                                          
XXXXXXXXXXXXXXXXXXXXXXXXXXXXXXXXXXXXXXXXXXXXXXXXXXXXXXXXXXXXXXXXXXXXXXXXXXXXXXXXXXXXXXXXXXXXXXXXXXXXXXXXXX
XXXXXXXXXXXXXXXXXXXXXXXXXXXXXXXXXXXXXXXXXXXXXXXXXXXXXXXXXXXXXXXXXXXXXXXXXXXXXXXXXXXXXXXXXXXXXXXXXXXXXXXXXX
                                               D                                     D                    
                                               D                                     D                    
                                               D                                     D                    
                                               D                                     D                    
                                               D                                     D                    
XXXXXXXXXXXXXXXXXXXXXXXXXXXXXX  XXXXXXXXXXXXXXXX                                     D                    
XXXXXXXXXXXXXXXXXXXXXXXXXXXXXX  XXXXXXXXXXXXXXXX                                     D                    
              D``````````````````````    GGGGGXX                                     D                    
              D````````````````````        GGGXX                                     D                    
              D````````````````           GGGGXX                                     D                    
XXXXXXXXXXXXXXX```````````````              GGXX                                     D                    
XXXXXXXXXXXXXXX```````````````                XXXXXXXXXXXXXXXXXXXXXXXXXXXXXXXXXXXXXXXXDDDDDDDDDDDDDDDDDDDD
             XX`````````````                  XXXXXXXXXXXXXXXXXXXXXXXXXXXXXXXXXXXXXXXX                    
             XX```````````                                               GGGGGGGGG  XX                    
             XX```````                                                    GGGGGG    XX                    
             XX````                                                         GGGGG   XX                    
             XX                                                            GGGG     XX                    
             XX                                                          GG   GG    XX                    
             XX                                     G                               XX                    
             XX                                    GGG                              XX                    
             XX                                   GGGGG                             XXD                   
             XX                                     GGGG                            XXDD                  
             XX                                     GGG                             XX DD                 
                                                    GGGGG                               DD                
                              G                        GG                                DD               
             XX             GGGGG     GG     GG        GGGG  GG  GG       G         XX    DD              
             XX              GGGG     GGGG GGGGGG    GGGGGGGG  GG GGG    GGG        XX     DD             
             XX                      GGGGGGGGGGGGG                GGGGGGGG          XX      DD            
             XX                     VVVVVVVVVVVVVVV               VVVVVVVV          XX       DD           
N:map7,E:map5,W:map3,S:map1
