                                                                                                          
                                                                                                          
XXXXXXXXXXXXXXXXXXXXXXXXXXXXXXXXXXXXXXXXXXXXXXXXXXXXXXXXXXXXXXXXXXXXXXXXXXXXXXXXXXXXXXXXXXXXXXXXXXXXXXXXXX
XXXXXXXXXXXXXXXXXXXXXXXXXXXXXXXXXXXXXXXXXXXXXXXXXXXXXXXXXXXXXXXXXXXXXXXXXXXXXXXXXXXXXXXXXXXXXXXXXXXXXXXXXX
                                               D               F             F      XX                    
           F                         F         D   F                                XX                    
                    F F  F                     D                                    XX                    
     F          F F                            D                                    XX                    
                                 F             D                       F F F        XX     FF             
XXXXXXXXXXXXXXXXXXXXXXXXXXXXXX  XXXXXXXXXXXXXXXX       F        F     F             XX                    
XXXXXXXXXXXXXXXXXXXXXXXXXXXXXX  XXXXXXXXXXXXXXXX                                    XX                    
              D                          GGGGGXX                                    XX      F             
              D                            GGGXX  FF                      F         XX      FF            
              D                           GGGGXX                                    XX                    
XXXXXXXXXXXXXXX                             GGXX                                    XX                    
XXXXXXXXXXXXXXX                               XXXXXXXXXXXXXXXXXXXXXXXXXXXXXXXXXXXXXXXXDDDDDDDDDDDDDDDDDDDD
       F     XX                               XXXXXXXXXXXXXXXXXXXXXXXXXXXXXXXXXXXXXXXX                    
             XX                                                          GGGGGGGGG  XX     F    F         
             XX                                                           GGGGGG    XX             F      
             XX                                                             GGGGG   XX                    
       F     XX                                                            GGGG     XX                    
   F F       XX                                                          GG   GG    XX        F           
             XX                                     G                               XX       F            
             XX                                    GGG                              XX                    
             XX                                   GGGGG                             XXX        F          
             XX                                     GGGG                            XXXX                  
             XX                                     GGG                             XX XX                 
         FF                                         GGGGG                               XX          F     
      FF                      G                        GG                                XX               
             XX             GGGGG     GG     GG        GGGG  GG  GG       G         XX    XX              
             XX              GGGG     GGGG GGGGGG    GGGGGGGG  GG GGG    GGG        XX     XX             
             XX                      GGGGGGGGGGGGG                GGGGGGGG          XX      XX            
             XX                     VVVVVVVVVVVVVVV               VVVVVVVV          XX       XX           
N:map7,E:map5,W:map3,S:map1
