                                        VVVVVVVVVV       XX              XX       NNNNNNNNNNNNNNNNNNNNNNNN
                                         GG GGGGG        XX              XX      NNNNNNNNNNNNNNNNNNNNNNNNN
XXXXXXXXXXXX                              G  GGG         XX              XX     NNNNNNNNNNNNNNNNNNNNNNNNNN
XXXXXXXXXXXX                                             XXXXXXXXXXXXXXXXXX     NNNNNNNNNNNNNNNNNNNNNNNNNN
          XX                                             XXXXXXXXXXXXXXXXXX     NNNNNNNNNNNNNNNNNNNNNNNNNN
          XX                                          FFF                       NNNNNNNNNNNNNNNNNNNNNNNNNN
          XX                                                                   NNNNNNNNNNNNNNNNNNNNNNNNNNN
          XX                     GG                                           NNNNNNNNNNNNNNNNNNNNNNNNNNNN
          XX                    GGGGG                                        NNNNNNNNNNNNNNNNNNNNNNNNNNNNN
          XX                    GGGGG                                 MM    NNNNNNNNNNNNNNNNNNNNNNNNNNNNNN
          XX                     GGG                                 MMMMMMNNNNNNNNNNNNNNNNNNNNNNNNNNNNNNN
          XX                      G                      FF         MMMMMMMMMMNNNNNNNNNNNNNNNNNNNNNNNNNNNN
          XX                                                         MMMMMMMMMMMMNNNNNNNNNNNNNNNNNNNNNNNNN
          XX                                    GG                   NNNNMMMMMMMMMMMNNNNNNNNNNNNNNNNNNNNNN
          XX                                  GGGGG        FF      NNNNNNNNNMMMMMMMMMMMNNNNNNNNNNNNNNNNNNN
DDDDDDDDDDXX               GG                 GGGGG               NNNNNNNNNNNNNMMMMMMMMMMMNNNNNNNNNNNNNNNN
          XX              GGGGG                GGG                GNNNNNNNNNNNNNNNMMMMMMMMMMMNNNNNNNNNNNNN
          XX              GGGGG                 G              GGGGGGNNNNNNNNNNNNNNNNMMMMMMMNNNNNNNNNNNNNN
          XX               GGG       GG                         GGGGNNNNNNNNNNNNNNNNNNNNMMMNNNNNNNNNNNNNNN
          XX                G       GGGGG                       GGGNNNNNNNNNNNNNNNNNNNNNNNNNNNNNNNNNNNNNNN
          XX                        GGGGG                        NNNNNNNNNNNNNNNNNNNNNNNNNNNNNNNNNNNNNNNNN
          XX                         GGG                        NNNNNNNNNNNNNNNNNNNNNNNNNNNNNNNNNNNNNNNNNN
          XX                          G                         NNNNNNNNNNNNNNNNNNNNNNNNNNNNNNNNNNNNNNNNNN
          XX                                                    NNNNNNNNNNNNNNNNNNNNNNNNNNNNNNNNNNNNNNNNNN
          XX                                         G           NNNNNNNNNNNNNNNNNNNNNNNNNNNNNNNNNNNNNNNNN
           XX                                     G  GGG           NNNNNNNNNNNNNNNNNNNNNNNNNNNNNNNNNNNNNNN
            XX                               G    GG GGGG            NNNGGGGNNNNNNNNNNNNNNNNNNNNNNNNNNNNNN
     FF      XX                            GGGG   GGGG             GGGGGGGGGGGGNNNNNNNNNNNNNNNNNNNNNNNNNNN
          FF  XX                            GGGG GGG              GGGGGGG GGGG  NNNNNNNNNNNNNNNNNNNNNNNNNN
   FF          XX                            GGGGGG                GGGGGG   GG    NNNNNNNNNNNNNNNNNNNNNNNN
        FF      XX FF                      GGGGGGG                   GGG           NNNNNNNNNNNNNNNNNNNNNNN
                 XX                     GGGGGGGGG                                   NNNNNNNNNNNNNNNNNNNNNN
                  XX                    VVVVVVVVVV                                  NNNNNNNNNNNNNNNNNNNNNN
N:map8,W:map4,S:map2
