VVVVVVVVVVVVVVVVVVVVVVVVVVVVVVVVVVVVVVVVVVVVVVVVVVVVVVVVVVVVVVVVVVVVVVVVVVVVVVVVVVVVVVVVVVVVVVVVVVVVVVVVVV
V                                                                                                         
V     MMMMM     MMMMM     MMMMM     MMMMM     MMMMM     MMMMM                                             
V     MMMMM     MMMMM     MMMMM     MMMMM     MMMMM     MMMMM                                             
V     MMMMM     MMMMM     MMMMM     MMMMM     MMMMM     MMMMM                                             
V     MMMMM     MMMMM     MMMMM     MMMMM     MMMMM     MMMMM                                             
V     MMMMM     MMMMM     MMMMM     MMMMM     MMMMM     MMMMM                               F     F       
V     MMMMM     MMMMM     MMMMM     MMMMM     MMMMM     MMMMM                                             
V                                                                                                     F   
V                                                                                                         
V     MMMMM     MMMMM     MMMMM                                                                           
V     MMMMM     MMMMM     MMMMM                                                                          X
V     MMMMM     MMMMM     MMMMM                                                                         XX
V  F  MMMMM     MMMMM     MMMMM                                                                        XX 
V     MMMMM     MMMMM     MMMMM                                                                       XX  
V     MMMMM     MMMMM     MMMMM                                                                      XX   
V                                                                                                G G XX   
XXXXXXXXXXXXXXX                                                                                  GG XX    
XXXXXXXXXXXXXXX                                                                               GG G  XX    
V            XX                                             GG                                GGGG        
V            XX                                     G G G   G                                   GG        
V            XX                                    GGGGGGGG                                    GGG        
V            XX                                    GGGGGGGG                                  GGGG         
V            XX                                     GGGGG             XXXXXXXXXXXXXXXXXXXXXXXXXXXXXXXX    
V      F     XX                                       G               XXXXXXXXXXXXXXXXXXXXXXXXXXXXXXXX    
V            XX                                                       XX           F                 X    
VXXXXXXXXX   XX                                                       XX     F                 F     X    
VXXXXXXXXX   XX                                                       XX            F                X    
V            XX                                                       XX                             XFF  
V            XX                                                       XX              F              X    
V            XX                                                       XXXXXXXXXXXXXXXXXXXXXXXXXXXXXXXX    
V            XX                                                                                           
V            XX                                                                                           
E:map7,S:map3
