VVVVVVVVVVVVVVVVVVVVVVVVVXX                                                    XXVVVVVVVVVVVVVVVVVVVVVVVVV
                         XX                                                    XX                         
          GG             XX                                                    XX             GG          
        GGGGG            XX                                                    XX            GGGGG        
        GGGGG            XX                                    F             F XX            GGGGG        
         GGG       XXXXXXXX          F             F                           XXXXXXXX       GGG         
          G  XXXXXXXXXXXX                                                        XXXXXXXXXXXX  G          
     F   XXXXXX F F                                                                        XXXXXX         
      XXXXXX                     F                                     F F F                  XXXXXX      
   XXXXX                                               F        F     F                           XXXXX   
 XXXX                                          XXXXXXXX                                              XXXX 
XXX                                      XXXXXXX      XXXXXXX                               F          XXX
X                                XXXXXXXXX                  XXXXXXXXX     F                 FF           X
                            XXXXXXX              XXXX              XXXXXXX                                
                         XXXXXX        G G G    XXXXXX    G G G        XXXXXX                             
                      XXXXX             GGG      XXXX      GGG             XXXXX         F                
       F            XXXX       XXXX      G                  G      XXXX       XXXX                        
                  XXXX        XXXXXX                              XXXXXX        XXXX       F    F         
                XXXX           XXXX                                XXXX           XXXX             F      
               XXX      G G G                                            G G G      XXX                   
       F      XXX        GGG                                              GGG        XXX                  
   F F       XXX          G                                                G          XXX     F           
             XX     XXXX                          GG                          XXXX     XX    F            
             XX    XXXXXX                        GGGG                        XXXXXX    XX                 
                    XXXX                        GGGGGG                        XXXX             F          
                                                 GGGG                                                     
                                                  GG                                                      
         FF                                       GG                                                F     
      FF                                                                                                  
                                                                                                          
                                                                                                          
                                                                                                          
                                                                                                          
N:map9,E:map8,W:map6,S:map4
