VVVVVVVVVVVVVVVVVVVVVVVVVXX                                                    XXVVVVVVVVVVVVVVVVVVVVVVVVV
                         XX                                                    XX                         
          GG             XX                                                    XX             GG          
        GGGGG            XX                                                    XX            GGGGG        
        GGGGG            XX                                                    XX            GGGGG        
         GGG       XXXXXXXX                                                    XXXXXXXX       GGG         
          G  XXXXXXXXXXXX                                                        XXXXXXXXXXXX  G          
         XXXXXX                                                                            XXXXXX         
      XXXXXX                                                                                  XXXXXX      
   XXXXX                                                                                          XXXXX   
 XXXX                                          XXXXXXXX                                              XXXX 
XXX                                      XXXXXXX      XXXXXXX                                          XXX
X                                XXXXXXXXX                  XXXXXXXXX                                    X
                            XXXXXXX              XXXX              XXXXXXX                                
                         XXXXXX        G G G    XXXXXX    G G G        XXXXXX                             
                      XXXXX             GGG      XXXX      GGG             XXXXX                          
                    XXXX       XXXX      G                  G      XXXX       XXXX                        
                  XXXX        XXXXXX                              XXXXXX        XXXX                      
                XXXX           XXXX                                XXXX           XXXX                    
               XXX      G G G                                            G G G      XXX                   
              XXX        GGG                                              GGG        XXX                  
             XXX          G                                                G          XXX                 
             XX     XXXX                          GG                          XXXX     XX                 
             XX    XXXXXX                        GGGG                        XXXXXX    XX                 
                    XXXX                        GGGGGG                        XXXX                        
                                                 GGGG                                                     
                                                  GG                                                      
                                                  GG                                                      
                                                                                                          
                                                                                                          
                                                                                                          
                                                                                                          
                                                                                                          
N:map9,E:map8,W:map6,S:map4
