XXXXXXXXXXXXXXXXXXXXXXXXXXXXXXXXXXXXXXXXXXXXXXXXXXXXXXXXXXXXXXXXXXXXXXXXXXXXXXXXXXXXXXXXXXXXXXXXXXXXXXXXXX
X                                                                                                        X
X                                                 MMMM                                                   X
X                                                MMMMMM                                                  X
X                                                MMMMMM                                                  X
X                  XXXXXXXX                       MMMM                         XXXXXXXX                  X
X            XXXXXXXXXXXX     MMMM                                    MMMM       XXXXXXXXXXXX            X
X        XXXXXX              MMMMMM                                  MMMMMM                XXXXXX        X
X     XXXXXX                 MMMMMM                                  MMMMMM                   XXXXXX     X
X  XXXXX                      MMMM                                    MMMM                        XXXXX  X
X XXX                                                                                                XXX X
X X                                                                                                    X X
X                                                                                                        X
X                                                                                                        X
X                                                                                                        X
X                       MMMM                                                  MMMM                       X
X                      MMMMMM                                                MMMMMM                      X
X                      MMMMMM                                                MMMMMM                      X
X                       MMMM                                                  MMMM                       X
X                                                                                                        X
X                                                                                                        X
X                                                                                                        X
X                                                                                                        X
X                                                                                                        X
X                            MMMM                                        MMMM                            X
X                           MMMMMM                                      MMMMMM                           X
X                        XX MMMMMM                                      MMMMMM XX                        X
X                        XX  MMMM                                        MMMM  XX                        X
X                        XX                                                    XX                        X
X                        XX                                                    XX                        X
X                        XX                                                    XX                        X
X                        XX                                                    XX                        X
XVVVVVVVVVVVVVVVVVVVVVVVVXX                                                    XXVVVVVVVVVVVVVVVVVVVVVVVVX
S:map7
